Компания "LIDER CLASSIC" - производитель мебели с европейским качеством, которая поставила себе цель - производство мебели высокого класса по доступным ценам. Мебель, выполненая профессионалами, предназначена для того, что бы подчеркнуть индивидуальность вашего дома или квартиры, удачно вписаться в интерьер и стать вашим помощником.
Спальный гарнитур "Грация " выполнена в классичеком стиле. Благодаря цветовой комбинации белого и золота с изображением узора версаче , ваш интерьер будет выглядеть современно  и эксклюзивно.

Цвет	Белый
Материал	Корпус: ЛДСП,
Фасад: МДФ
Производитель	LIDER CLASSIC 
Шкаф	В1842 х Ш2240 х Г637 мм
Кровать	В1050 х Ш1650 х Г2098 мм
Спальное место	Ш1600 x Д2000 мм
Зеркало	В700 х Ш850 х Г20 мм
Прикроватная тумба	В460 х Ш610 х Г360 мм
Комод	В900 х Ш862 х Г430 мм)

Фабрика комплектует кровати ЛДСП основанием. Это простая, ровная основа для матраса.
Характеристики
Материал	Зеркало, ЛДСП, МДФ
Спальное место, см	160х200
Состояние	Поставляется в разобранном виде. Инструкция по сборке и вся фурнитура в комплекте.
Упаковка	Надёжная фабричная упаковка. Коробки из трехслойного гофрокартона класса Т-23. Усиление углов и стёкол дополнительным уплотнителем.
Маркировка	Стикер производителя на каждой коробке с отметкой отдела контроля качества

159500

